11111111111
10000000001
10001000001
100010P0001
1000000C0C1
11111111111