11111111111
10001E00001
10001010001
10001100001
10001000001
10001000001
10001000001
10000C000P1
11111111111